0000000011
1011111011
1001110001
1010111111
1000000011
1101111011
1100111011
1110111111
1000000000
1111111111